1111111111111111
1P010C0C00001
1000011111C0111
100011E00000111
11111111111111