111111111111111
1P010C0001C0001
100100100100101
100100100100101
100100100100101
10C00010C0001E1
111111111111111