1111111111111
1PP10C0C00001
1PP0011111C01
100011E000001
1111111111111