1111111111111
1P010C0C00001
1000011111C01
1000110000001
1111111111111