1111111111111
10010C0C00001
1000011111C01
100011E000001
1111101111011