1111111111111
1P010C0C00001
1000011111C01
100011E000001
1111101111011